Un	DET:ART	un
véritable	ADJ	véritable
voyage	NOM	voyage
dans	PRP	dans
un	DET:ART	un
monde	NOM	monde
imaginaire	ADJ	imaginaire
plus	ADV	plus
que	KON	que
palpable	ADJ	palpable
que	KON	que
James	NAM	James
Cameron	NAM	Cameron
nous	PRO:PER	nous
fait	VER:pres	faire
visiter	VER:infi	visiter
d’une	NOM	d’une
manière	NOM	manière
innovante	ADJ	innovante
pour	PRP	pour
nous	PRO:PER	nous
faire	VER:infi	faire
prendre	VER:infi	prendre
conscience	NOM	conscience
de	PRP	de
la	DET:ART	le
richesse	NOM	richesse
de	PRP	de
la	DET:ART	le
nature	NOM	nature
pourtant	ADV	pourtant
si	ADV	si
proche	ADJ	proche
de	PRP	de
nous	PRO:PER	nous
.	SENT	.
Ce	PRO:DEM	ce
n’est	NOM	n’est
donc	ADV	donc
pas	ADV	pas
qu’une	NOM	qu’une
démonstration	NOM	démonstration
technique	ADJ	technique
ni	KON	ni
qu’un	ADJ	qu’un
film	NOM	film
d’action	NOM	d’action
mais	KON	mais
bien	ADV	bien
plus	ADV	plus
que	KON	que
cela	PRO:DEM	cela
.	SENT	.
Une	DET:ART	un
rencontre	NOM	rencontre
et	KON	et
experience	NOM	experience
unique	ADJ	unique
à	PRP	à
vivre	VER:infi	vivre
en	PRP	en
salle	NOM	salle
.	SENT	.
Et	KON	et
une	DET:ART	un
fois	NOM	foi|fois
sorti	VER:pper	sortir
du	PRP:det	du
cinéma	NOM	cinéma
,	PUN	,
de	PRP	de
retour	NOM	retour
dans	PRP	dans
notre	DET:POS	notre
monde	NOM	monde
réel	ADJ	réel
on	PRO:PER	on
se	PRO:PER	se
dit	VER:pres	dire
que	KON	que
le	DET:ART	le
voyage	NOM	voyage
été	VER:pper	être
bien	ADV	bien
trop	ADV	trop
court	ADJ	court
.	SENT	.
On	PRO:PER	on
a	VER:pres	avoir
alors	ADV	alors
qu’une	NOM	qu’une
envie	NOM	envie
:	PUN	:
retourner	VER:infi	retourner
sur	PRP	sur
Pandora	NOM	Pandora
