Evidemment	NOM	Evidemment
bluffant	VER:ppre	bluffer
au	PRP:det	au
point	NOM	point
de	PRP	de
vue	NOM	vue
effets	NOM	effet
spéciaux	ADJ	spécial
,	PUN	,
cette	PRO:DEM	ce
oeuvre	NOM	œuvre
est	VER:pres	être
incontestablement	ADV	incontestablement
surprenante	ADJ	surprenant
,	PUN	,
très	ADV	très
originale	ADJ	original
sans	KON	sans
parlé	VER:pper	parler
de	PRP	de
toutes	PRO:IND	tout
les	DET:ART	le
subtilités	NOM	subtilité
quant	PRP	quant
au	PRP:det	au
language	NOM	language
naavi	ADJ	naavi
'	PUN	'
entèrement	NOM	entèrement
créé	VER:pper	créer
,	PUN	,
d'	PRP	de
un	DET:ART	un
monde	NOM	monde
travaillé	VER:pper	travailler
dans	PRP	dans
sa	DET:POS	son
globalité(faune	NOM	globalité(faune
,	PUN	,
flore	NOM	flore
,	PUN	,
environnement	NOM	environnement
)	PUN	)
.	SENT	.
En	PRP	en
effet	NOM	effet
,	PUN	,
j'	PRO:PER	je
ai	VER:pres	avoir
bien	ADV	bien
aimé	VER:pper	aimer
le	DET:ART	le
concept	NOM	concept
de	PRP	de
communion	NOM	communion
entre	PRP	entre
nature	NOM	nature
et	KON	et
indigènes	NOM	indigène
.	SENT	.
Cameron	NAM	Cameron
a	VER:pres	avoir
su	VER:pper	savoir
aussi	ADV	aussi
mettre	VER:infi	mettre
sa	DET:POS	son
touche	NOM	touche
écolo	NOM	écolo
avec	PRP	avec
succès	NOM	succès
contrairement	ADV	contrairement
à	PRP	à
certains	PRO:IND	certain
réalisateurs	NOM	réalisateur
tels	PRO:DEM	tel
que	PRO:REL	que
M.	NOM	monsieur
Night	NAM	Night
Shyamalan	NAM	Shyamalan
(	PUN	(
Phénomène	NAM	Phénomène
)	PUN	)
ou	KON	ou
encore	ADV	encore
Scott	NAM	Scott
Derrickson	NAM	Derrickson
(	PUN	(
Le	DET:ART	le
jour	NOM	jour
où	PRO:REL	où
la	DET:ART	le
Terre	NAM	Terre
s'	PRO:PER	se
arrêta	VER:simp	arrêter
)	PUN	)
.	SENT	.
Ayant	VER:ppre	avoir
assisté	VER:pper	assister
pour	PRP	pour
la	DET:ART	le
première	NUM	premier
fois	NOM	foi|fois
à	PRP	à
une	DET:ART	un
séance	NOM	séance
en	PRO:PER	en
3D	VER:futu	3D
je	PRO:PER	je
ne	ADV	ne
peux	VER:pres	pouvoir
pas	ADV	pas
comparer	VER:infi	comparer
mais	KON	mais
je	PRO:PER	je
n'	ADV	ne
ai	VER:pres	avoir
pas	ADV	pas
été	VER:pper	être
déçu	VER:pper	décevoir
.	SENT	.
