malgré	PRP	malgré
le	DET:ART	le
succès	NOM	succès
rencontré	VER:pper	rencontrer
je	PRO:PER	je
restais	VER:impf	rester
sceptique	ADJ	sceptique
concernant	PRP	concernant
ce	PRO:DEM	ce
film	NOM	film
...	PUN	...
mais	KON	mais
la	PRO:PER	la
je	PRO:PER	je
dois	VER:pres	devoir
bien	ADV	bien
avouer	VER:infi	avouer
cameron	NOM	cameron
a	VER:pres	avoir
fait	VER:pper	faire
très	ADV	très
fort	ADV	fort
une	DET:ART	un
fois	NOM	foi|fois
de	PRP	de
plus	ADV	plus
.	SENT	.
Certes	ADV	certes
l'	DET:ART	le
histoire	NOM	histoire
restera	VER:futu	rester
assez	ADV	assez
simple	ADJ	simple
rappelant	VER:ppre	rappeler
bons	ADJ	bon
nombre	NOM	nombre
de	PRP	de
films	NOM	film
à	PRP	à
la	DET:ART	le
sauce	NOM	sauce
western	NOM	western
mais	KON	mais
visuellement	ADV	visuellement
et	KON	et
émotionnellement	NOM	émotionnellement
quelle	PRO:REL	quel
claque	VER:pres	claquer
majestueuse	ADJ	majestueux
!	SENT	!
on	PRO:PER	on
est	VER:pres	être
ému	VER:pper	émouvoir
par	PRP	par
ce	PRO:DEM	ce
monde	NOM	monde
enchanteur	ADJ	enchanteur
aux	PRP:det	au
mille	NUM	mille
couleurs	NOM	couleur
,	PUN	,
et	KON	et
les	DET:ART	le
personnages	NOM	personnage
deviennent	VER:pres	devenir
quand	ADV	quand
a	VER:pres	avoir
eux	PRO:PER	eux
rapidement	ADV	rapidement
attachant	VER:ppre	attacher
!	SENT	!
une	DET:ART	un
belle	ADJ	beau
prouesse	NOM	prouesse
technique	ADJ	technique
qui	PRO:REL	qui
je	PRO:PER	je
l'	PRO:PER	la|le
espère	VER:pres	espérer
,	PUN	,
gardera	VER:futu	garder
toute	PRO:IND	tout
sa	DET:POS	son
saveur	NOM	saveur
en	PRP	en
support	NOM	support
2-D	ADJ	2-D
...	PUN	...
.	SENT	.
.	SENT	.
