Une	DET:ART	un
demie	ADJ	demi
étoile	NOM	étoile
pour	PRP	pour
l'	DET:ART	le
incrustation	NOM	incrustation
3D	ADJ	3D
qui	PRO:REL	qui
est	VER:pres	être
vraiment	ADV	vraiment
sympa	ADJ	sympa
...	PUN	...
pourquoi	ADV	pourquoi
qu'	KON	que
une	DET:ART	un
moitié	NOM	moitié
?	SENT	?
Car	KON	car
celle	PRO:DEM	celui
-ci	ADV	-ci
est	VER:pres	être
gâchée	VER:pper	gâcher
par	PRP	par
un	DET:ART	un
monde	NOM	monde
dépourvu	VER:pper	dépourvu
d'	PRP	de
une	DET:ART	un
once	NOM	once
d'	PRP	de
imagination	NOM	imagination
.	SENT	.
Il	PRO:PER	il
existe	VER:pres	exister
tellement	ADV	tellement
de	PRP	de
films/mangas/jeux/livres	NOM	films/mangas/jeux/livres
plus	ADV	plus
imaginatifs	ADJ	imaginatif
!	SENT	!
Le	DET:ART	le
seul	ADJ	seul
détail	NOM	détail
que	PRO:REL	que
j'	PRO:PER	je
ai	VER:pres	avoir
trouvé	VER:pper	trouver
intéressant	ADJ	intéressant
était	VER:impf	être
le	DET:ART	le
lien	NOM	lien
entre	PRP	entre
les	DET:ART	le
Na'vis	NAM	Na'vis
et	KON	et
les	DET:ART	le
animaux	NOM	animal
mais	KON	mais
n'	ADV	ne
est	VER:pres	être
pas	ADV	pas
vraiment	ADV	vraiment
approfondi	VER:pper	approfondir
...	PUN	...
pourquoi	ADV	pourquoi
pas	ADV	pas
ce	PRO:DEM	ce
même	ADJ	même
lien	NOM	lien
entre	PRP	entre
eux	PRO:PER	eux
?	SENT	?
non	ADV	non
ils	PRO:PER	il
ont	VER:pres	avoir
plutôt	ADV	plutôt
l'	DET:ART	le
habitude	NOM	habitude
de	PRP	de
"	PUN:cit	"
faire	VER:infi	faire
l'	DET:ART	le
amour	NOM	amour
"	PUN:cit	"
exactement	ADV	exactement
comme	ADV	comme
nous.	ADJ	nous.
.	SENT	.
ça	PRO:DEM	cela
tombe	VER:pres	tomber
bien	ADV	bien
pour	PRP	pour
Jack	NAM	Jack
Sully	NAM	Sully
que	KON	que
la	DET:ART	le
sodomie	NOM	sodomie
n'	ADV	ne
était	VER:impf	être
pas	ADV	pas
une	DET:ART	un
pratique	NOM	pratique
courante	ADJ	courant
des	PRP:det	du
Na'vis	NAM	Na'vis
!	SENT	!
^^	NOM	^^
Dommage	NAM	Dommage
...	PUN	...
avec	PRP	avec
ses	DET:POS	son
moyens	NOM	moyen
,	PUN	,
cela	PRO:DEM	cela
aurait	VER:cond	avoir
pu	VER:pper	pouvoir
être	VER:infi	être
un	DET:ART	un
film	NOM	film
génial	ADJ	génial
!	SENT	!
