Un	DET:ART	un
scénario	NOM	scénario
très	ADV	très
limiter	VER:infi	limiter
,	PUN	,
des	PRP:det	du
gag	NOM	gag
qui	PRO:REL	qui
tombe	VER:pres	tomber
le	DET:ART	le
plus	ADV	plus
souvent	ADV	souvent
a	VER:pres	avoir
plat	ADJ	plat
,	PUN	,
certain	PRO:IND	certain
on	PRO:PER	on
réussi	VER:pper	réussir
a	VER:pres	avoir
me	PRO:PER	me
faire	VER:infi	faire
rire	VER:infi	rire
.	SENT	.
C'	PRO:DEM	ce
est	VER:pres	être
la	DET:ART	le
preuve	NOM	preuve
qu'	KON	que
un	DET:ART	un
beau	ADJ	beau
casting	NOM	casting
ne	ADV	ne
fait	VER:pres	faire
pas	ADV	pas
en	PRP	en
bon	ADJ	bon
film	NOM	film
.	SENT	.
Une	DET:ART	un
étoile	NOM	étoile
a	VER:pres	avoir
Alain	NAM	Alain
Delon	NAM	Delon
qui	PRO:REL	qui
tiens	VER:pres	tenir
très	ADV	très
bien	ADV	bien
son	DET:POS	son
rôle	NOM	rôle
de	PRP	de
César	NAM	César
comparer	VER:infi	comparer
au	PRP:det	au
autre	ADJ	autre
acteur	NOM	acteur
.	SENT	.
De	PRP	de
plus	ADV	plus
les	DET:ART	le
guest	ADJ	guest
stars	NOM	star
sportive	ADJ	sportif
apparaissent	VER:pres	apparaître
que	KON	que
très	ADV	très
peu	ADV	peu
dans	PRP	dans
le	DET:ART	le
film	NOM	film
et	KON	et
il	PRO:PER	il
sont	VER:pres	être
totalement	ADV	totalement
inutile	ADJ	inutile
.	SENT	.
Passez	VER:pres	passer
votre	DET:POS	votre
chemin	NOM	chemin
et	KON	et
allez	VER:pres	aller
voir	VER:infi	voir
un	DET:ART	un
autre	ADJ	autre
film	NOM	film
au	PRP:det	au
cinéma	NOM	cinéma
et	KON	et
attendez	VER:pres	attendre
qu'	KON	que
il	PRO:PER	il
soit	VER:subp	être
a	VER:pres	avoir
location	NOM	location
cela	PRO:DEM	cela
vous	PRO:PER	vous
coûtera	VER:futu	coûter
moins	ADV	moins
cher	ADV	cher
et	KON	et
vous	PRO:PER	vous
louperez	VER:futu	louper
pas	ADV	pas
grand	ADJ	grand
chose	NOM	chose
