Que	KON	que
dire	VER:infi	dire
de	PRP	de
ce	PRO:DEM	ce
film	NOM	film
?	SENT	?
Peut-être	ADV	peut-être
qu'	KON	que
avec	PRP	avec
78	NUM	@card@
millions	NOM	million
d'	PRP	de
euros	NOM	euro
de	PRP	de
budget	NOM	budget
c'	PRO:DEM	ce
est	VER:pres	être
très	ADV	très
regrettable	ADJ	regrettable
de	PRP	de
faire	VER:infi	faire
un	DET:ART	un
film	NOM	film
pour	PRP	pour
mettre	VER:infi	mettre
en	PRP	en
scène	NOM	scène
des	PRP:det	du
stars	NOM	star
,	PUN	,
alors	ADV	alors
que	KON	que
les	DET:ART	le
américains	ADJ	américain
payentde	NOM	payentde
bns	NOM	bns
scénaristes	NOM	scénariste
pourécrire	VER:simp	pourécrire
un	DET:ART	un
film	NOM	film
qui	PRO:REL	qui
tient	VER:pres	tenir
la	DET:ART	le
route	NOM	route
.	SENT	.
Voilà	ADV	voilà
je	PRO:PER	je
regrette	VER:pres	regretter
que	KON	que
le	DET:ART	le
film	NOM	film
ne	ADV	ne
soit	VER:subp	être
pas	ADV	pas
plus	ADV	plus
écrit	VER:pper	écrire
mais	KON	mais
plus	ADV	plus
basé	VER:pper	baser
sur	PRP	sur
le	DET:ART	le
passage	NOM	passage
de	PRP	de
stars	NOM	star
internationales	ADJ	international
.	SENT	.
Certes	ADV	certes
certains	PRO:IND	certain
passages	NOM	passage
sont	VER:pres	être
drôles	ADJ	drôle
(	PUN	(
peu	ADV	peu
nombreux	ADJ	nombreux
)	PUN	)
et	KON	et
Poelvoorde	NAM	Poelvoorde
est	VER:pres	être
parfait	VER:pper	parfaire
dans	PRP	dans
son	DET:POS	son
rôle	NOM	rôle
de	PRP	de
Brutus	NAM	Brutus
mais	KON	mais
tout	ADV	tout
cela	PRO:DEM	cela
est	VER:pres	être
bien	ADV	bien
faible	ADJ	faible
.	SENT	.
Je	PRO:PER	je
m'	PRO:PER	me
y	PRO:PER	y
attendais	VER:impf	attendre
malheureusement	ADV	malheureusement
mais	KON	mais
j'	PRO:PER	je
espère	VER:pres	espérer
que	KON	que
d'	PRP	de
autres	ADJ	autre
films	NOM	film
français	ADJ	français
à	PRP	à
gros	ADJ	gros
budget	NOM	budget
se	PRO:PER	se
monteront	VER:futu	monter
pour	PRP	pour
un	DET:ART	un
résultat	NOM	résultat
bien	ADV	bien
meilleur	ADJ	meilleur
.	SENT	.
Dommage	NOM	dommage
!	SENT	!
