Alors	ADV	alors
franchement	ADV	franchement
,	PUN	,
voila	VER:simp	voiler
le	DET:ART	le
genre	NOM	genre
de	PRP	de
film	NOM	film
que	KON	que
je	PRO:PER	je
ne	ADV	ne
supporte	VER:pres	supporter
pas	ADV	pas
.	SENT	.
Moi	PRO:PER	moi
qui	PRO:REL	qui
était	VER:impf	être
un	DET:ART	un
fan	NOM	fan
des	PRP:det	du
3	NUM	@card@
premiers	NUM	premier
opus	NOM	opus
,	PUN	,
celui	PRO:DEM	celui
-ci	ADV	-ci
est	VER:pres	être
à	PRP	à
oublier	VER:infi	oublier
très	ADV	très
vite	ADV	vite
.	SENT	.
Une	DET:ART	un
mise	NOM	mise
en	PRP	en
scène	NOM	scène
d'	PRP	de
épiléptique	NOM	épiléptique
avec	PRP	avec
changement	NOM	changement
de	PRP	de
plan	NOM	plan
toutes	PRO:IND	tout
les	DET:ART	le
demis	ADJ	demi
secondes	NOM	second|seconde
et	KON	et
filtre	NOM	filtre
d'	PRP	de
image	NOM	image
façon	NOM	façon
les	DET:ART	le
experts	NOM	expert
.	SENT	.
On	PRO:PER	on
dirait	VER:cond	dire
plus	ADV	plus
une	DET:ART	un
mauvaise	ADJ	mauvais
série	NOM	série
américaine	ADJ	américain
avec	PRP	avec
son	DET:POS	son
méchant	NOM	méchant
complètement	ADV	complètement
bidon	NOM	bidon
qu'	KON	que
un	DET:ART	un
véritable	ADJ	véritable
film	NOM	film
.	SENT	.
Le	DET:ART	le
scénario	NOM	scénario
est	VER:pres	être
véritablement	ADV	véritablement
nul	ADJ	nul
.	SENT	.
A	PRP	à
croire	VER:infi	croire
que	KON	que
notre	DET:POS	notre
bruce	NOM	bruce
avait	VER:impf	avoir
besoin	NOM	besoin
d'	PRP	de
argent	NOM	argent
frais	ADJ	frais
pour	PRP	pour
sa	DET:POS	son
nouvelle	ADJ	nouveau
villa	NOM	villa
californienne	ADJ	californien
.	SENT	.
N'	ADV	ne
y	PRO:PER	y
allez	VER:pres	aller
pas	ADV	pas
!	SENT	!
