Spectacle	NOM	spectacle
navrant	ADJ	navrant
!	SENT	!
Une	DET:ART	un
débauche	NOM	débauche
de	PRP	de
moyens	NOM	moyen
qui	PRO:REL	qui
accouchent	VER:pres	accoucher
d’une	NOM	d’une
réalisation	NOM	réalisation
prétentieuse	ADJ	prétentieux
à	PRP	à
l’humour	NOM	l’humour
lourdingue	ADJ	lourdingue
,	PUN	,
plombée	VER:pper	plomber
par	PRP	par
des	PRP:det	du
gags	NOM	gag
le	DET:ART	le
plus	ADV	plus
souvent	ADV	souvent
ratés	VER:pper	rater
.	SENT	.
Ceux	PRO:DEM	celui
qui	PRO:REL	qui
ont	VER:pres	avoir
aimé	VER:pper	aimer
les	DET:ART	le
répliques	NOM	réplique
pétillantes	ADJ	pétillant
du	PRP:det	du
film	NOM	film
d’Alain	ADJ	d’Alain
Chabat	NAM	Chabat
,	PUN	,
en	PRO:PER	en
seront	VER:futu	être
ici	ADV	ici
pour	PRP	pour
leurs	DET:POS	leur
frais	NOM	frai|frais
.	SENT	.
C’est	NOM	C’est
finalement	ADV	finalement
celui	PRO:DEM	celui
dont	PRO:REL	dont
on	PRO:PER	on
attendait	VER:impf	attendre
le	DET:ART	le
moins	ADV	moins
,	PUN	,
Alain	NAM	Alain
Delon	NAM	Delon
,	PUN	,
qui	PRO:REL	qui
tire	VER:pres	tirer
son	DET:POS	son
épingle	NOM	épingle
du	PRP:det	du
jeu	NOM	jeu
par	PRP	par
son	DET:POS	son
numéro	NOM	numéro
d’autoparodie	VER:pres	d’autoparodie
assez	ADV	assez
savoureux	ADJ	savoureux
,	PUN	,
aux	PRP:det	au
côtés	NOM	côté
d’un	ADJ	d’un
Benoît	NAM	Benoît
Poelvoorde	NAM	Poelvoorde
méritant	VER:ppre	mériter
face	NOM	face
à	PRP	à
une	DET:ART	un
écriture	NOM	écriture
aussi	ADV	aussi
indigente	ADJ	indigent
.	SENT	.
Quant	PRP	quant
à	PRP	à
Astérix	NAM	Astérix
Clovis	NAM	Clovis
Cornillac	NAM	Cornillac
et	KON	et
Obélix	NAM	Obélix
Gérard	NAM	Gérard
Depardieu	NAM	Depardieu
,	PUN	,
on	PRO:PER	on
ne	ADV	ne
saurait	VER:cond	savoir
trop	ADV	trop
se	PRO:PER	se
prononcer	VER:infi	prononcer
tant	ADV	tant
le	DET:ART	le
scénario	NOM	scénario
les	PRO:PER	la|le
relègue	VER:pres	reléguer
au	PRP:det	au
deuxième	NUM	deuxième
plan	NOM	plan
.	SENT	.
Les	DET:ART	le
apparitions	NOM	apparition
furtives	ADJ	furtif
et	KON	et
creuses	ADJ	creux
de	PRP	de
Zidane	NAM	Zidane
,	PUN	,
Tony	NAM	Tony
Parker	NAM	Parker
et	KON	et
Amélie	NAM	Amélie
Mauresmo	NAM	Mauresmo
relèvent	VER:pres	relever
d’un	ADJ	d’un
marketing	NOM	marketing
pathétique	ADJ	pathétique
.	SENT	.
Contentez	VER:pres	contenter
-vous	PRO:PER	vous
de	PRP	de
la	DET:ART	le
bande	NOM	bande
annonce	NOM	annonce
qui	PRO:REL	qui
réunit	VER:pres	réunir
les	DET:ART	le
meilleurs	ADJ	meilleur
instants	NOM	instant
,	PUN	,
et	KON	et
retournez	VER:pres	retourner
vite	ADV	vite
à	PRP	à
la	DET:ART	le
BD	ABR	BD
originale	ADJ	original
.	SENT	.
