vraiment	ADV	vraiment
déçu	VER:pper	décevoir
je	PRO:PER	je
m'	PRO:PER	me
nedormait	VER:impf	nedormait
devant	PRP	devant
les	DET:ART	le
dialogues	NOM	dialogue
et	KON	et
les	DET:ART	le
blagues	NOM	blague
sont	VER:pres	être
d'	PRP	de
une	DET:ART	un
lourdeur	NOM	lourdeur
...	PUN	...
c'	PRO:DEM	ce
est	VER:pres	être
a	VER:pres	avoir
prendre	VER:infi	prendre
les	DET:ART	le
spéctateurs	NOM	spéctateurs
pour	KON	pour
des	PRP:det	du
imbéciles	NOM	imbécile
puis	ADV	puis
Clovis	NAM	Clovis
Cornillac	NAM	Cornillac
est	VER:pres	être
vraiment	ADV	vraiment
null	NOM	null
dans	PRP	dans
le	DET:ART	le
role	ADJ	role
d'	PRP	de
Astérix	NAM	Astérix
,	PUN	,
Pitié	NAM	Pitié
Clavier	NAM	Clavier
revient	VER:pres	revenir
!	SENT	!
Sinon	KON	sinon
je	PRO:PER	je
met	VER:pres	mettre
1	NUM	@card@
étoile	NOM	étoile
pour	PRP	pour
les	DET:ART	le
effets	NOM	effet
spéciaux	ADJ	spécial
,	PUN	,
pour	PRP	pour
les	DET:ART	le
décors	NOM	décor
et	KON	et
pour	PRP	pour
le	DET:ART	le
prestation	NOM	prestation
de	PRP	de
Gérard	NAM	Gérard
deupardieu	ADJ	deupardieu
ainsi	ADV	ainsi
que	KON	que
celle	PRO:DEM	celui
de	PRP	de
Poolvorde	NAM	Poolvorde
qui	PRO:REL	qui
a	VER:pres	avoir
réussi	VER:pper	réussir
a	VER:pres	avoir
me	PRO:PER	me
faire	VER:infi	faire
décrocher	VER:infi	décrocher
quelques	PRO:IND	quelque
sourires	NOM	sourire
tout	ADV	tout
de	PRP	de
meme	NOM	meme
...	PUN	...
Bref	NAM	Bref
un	DET:ART	un
blockbuster	NOM	blockbuster
sans	PRP	sans
aucune	PRO:IND	aucun
utilité	NOM	utilité
une	DET:ART	un
bouse	NOM	bouse
comerciale	ADJ	comerciale
quoi	PRO:REL	quoi
...	PUN	...
