Avatar	NOM	avatar
offre	VER:pres	offrir
un	DET:ART	un
univers	NOM	univers
d'	PRP	de
une	DET:ART	un
richesse	NOM	richesse
incroyable	ADJ	incroyable
qui	PRO:REL	qui
nous	PRO:PER	nous
plonge	VER:pres	plonger
dans	PRP	dans
un	DET:ART	un
voyage	NOM	voyage
immersif	ADJ	immersif
dont	PRO:REL	dont
on	PRO:PER	on
a	VER:pres	avoir
du	PRP:det	du
mal	NOM	mal
a	VER:pres	avoir
s'	PRO:PER	se
en	PRP	en
remettre	VER:infi	remettre
après	PRP	après
2h40	NOM	2h40
de	PRP	de
film	NOM	film
.	SENT	.
James	NAM	James
Cameron	NAM	Cameron
film	NOM	film
son	DET:POS	son
univers	NOM	univers
avec	PRP	avec
brio	NOM	brio
en	PRP	en
dévoilant	VER:ppre	dévoiler
des	PRP:det	du
plans	NOM	plan
priviligiant	VER:ppre	priviligiant
la	DET:ART	le
découverte	NOM	découverte
d'	PRP	de
un	DET:ART	un
monde	NOM	monde
imaginaire	ADJ	imaginaire
d'	PRP	de
une	DET:ART	un
rare	ADJ	rare
beauté	NOM	beauté
.	SENT	.
Cameron	NAM	Cameron
réalise	VER:pres	réaliser
la	DET:ART	le
une	NUM	un
apopée	NOM	apopée
fantastique	ADJ	fantastique
impressionante	ADJ	impressionante
d'	PRP	de
une	DET:ART	un
grande	ADJ	grand
intensitée	NOM	intensitée
dramatique	ADJ	dramatique
malgré	PRP	malgré
un	DET:ART	un
scènario	NOM	scènario
un	DET:ART	un
peu	ADV	peu
simpliste	ADJ	simpliste
.	SENT	.
Les	DET:ART	le
acteurs	NOM	acteur
jouent	VER:pres	jouer
leurs	DET:POS	leur
rôles	NOM	rôle
avec	PRP	avec
justesse	NOM	justesse
et	KON	et
rendent	VER:pres	rendre
leurs	DET:POS	leur
personnages	NOM	personnage
en	PRP	en
image	NOM	image
de	PRP	de
synthèse	NOM	synthèse
très	ADV	très
attachant	ADJ	attachant
.	SENT	.
Avatar	NOM	avatar
ne	ADV	ne
révolutione	VER:subi	révolutione
pas	ADV	pas
le	DET:ART	le
cinéma	NOM	cinéma
du	PRP:det	du
genre	NOM	genre
sf	NOM	sf
mais	KON	mais
laissera	VER:futu	laisser
son	DET:POS	son
empreinte	NOM	empreinte
dans	PRP	dans
les	DET:ART	le
années	NOM	année
avenir	NOM	avenir
.	SENT	.
James	NAM	James
Cameron	NAM	Cameron
signe	VER:pres	signer
ca	VER:pper	ca
plus	ADV	plus
belle	ADJ	beau
réussite	NOM	réussite
après	PRP	après
Abyss	NAM	Abyss
et	KON	et
Titanic	NAM	Titanic
.	SENT	.
