A	PRP	à
partir	VER:infi	partir
d’un	ADJ	d’un
scénario	NOM	scénario
attendu	VER:pper	attendre
et	KON	et
quasiment	ADV	quasiment
standard	ADJ	standard
,	PUN	,
James	NAM	James
Cameron	NAM	Cameron
délivre	VER:pres	délivrer
l’une	NOM	l’une
des	PRP:det	du
œuvres	NOM	œuvre
majeurs	ADJ	majeur
du	PRP:det	du
cinéma	NOM	cinéma
d’animation	NOM	d’animation
du	PRP:det	du
XXIEME	NAM	XXIEME
siècle	NOM	siècle
et	KON	et
du	PRP:det	du
cinéma	NOM	cinéma
tout	ADV	tout
court	ADJ	court
.	SENT	.
Jouant	VER:ppre	jouer
sur	PRP	sur
les	DET:ART	le
attentes	NOM	attente
d’un	ADJ	d’un
public	ADJ	public
conquis	VER:pper	conquérir
d’avance	NOM	d’avance
,	PUN	,
il	PRO:PER	il
révolutionne	VER:pres	révolutionner
son	DET:POS	son
récit	NOM	récit
en	PRP	en
privilégiant	VER:ppre	privilégier
l’âme	NOM	l’âme
par	PRP	par
une	DET:ART	un
poésie	NOM	poésie
panthéiste	ADJ	panthéiste
puis	ADV	puis
laisse	VER:pres	laisser
exploser	VER:infi	exploser
les	DET:ART	le
corps	NOM	corps
lors	ADV	lors
de	PRP	de
combats	NOM	combat
vengeurs	ADJ	vengeur
aussi	ADV	aussi
jouissifs	ADJ	jouissif
que	KON	que
spectaculaires	ADJ	spectaculaire
.	SENT	.
Quand	KON	quand
on	PRO:PER	on
oublie	VER:pres	oublier
la	DET:ART	le
virtuosité	NOM	virtuosité
technique	ADJ	technique
d’une	NOM	d’une
œuvre	VER:pres	œuvrer
pour	PRP	pour
se	PRO:PER	se
laisser	VER:infi	laisser
gagner	VER:infi	gagner
par	PRP	par
l’émotion	NOM	l’émotion
qu’elle	ADJ	qu’elle
dégage	VER:pres	dégager
,	PUN	,
cela	PRO:DEM	cela
s’appelle	ADJ	s’appelle
l’art	NOM	l’art
.	SENT	.
DU	PRP:det	du
GRANT	NAM	GRANT
ART	NAM	Art
