je	PRO:PER	je
viens	VER:pres	venir
de	PRP	de
voir	VER:infi	voir
Avatar	NAM	Avatar
et	KON	et
j'	PRO:PER	je
ai	VER:pres	avoir
beaucoup	ADV	beaucoup
aimé	VER:pper	aimer
.	SENT	.
2h40	NOM	2h40
sans	PRP	sans
jamais	ADV	jamais
s'	PRO:PER	se
ennuyer	VER:infi	ennuyer
.	SENT	.
Le	DET:ART	le
film	NOM	film
fera	VER:futu	faire
surement	NOM	surement
partie	VER:pper	partir
des	PRP:det	du
rares	ADJ	rare
films	NOM	film
de	PRP	de
science	NOM	science
fiction	NOM	fiction
avec	PRP	avec
des	PRP:det	du
gros	ADJ	gros
moyens	NOM	moyen
technologiques	ADJ	technologique
employés	VER:pper	employer
et	KON	et
une	DET:ART	un
philosphie	NOM	philosphie
consistante	ADJ	consistant
.	SENT	.
Les	DET:ART	le
Na'vi	NAM	Na'vi
sont	VER:pres	être
tels	PRO:DEM	tel
ces	PRO:DEM	ce
peuples	NOM	peuple
qui	PRO:REL	qui
subsistent	VER:pres	subsister
encore	ADV	encore
sur	PRP	sur
notre	DET:POS	notre
planete	NOM	planete
et	KON	et
qui	PRO:REL	qui
considèrent	VER:pres	considérer
que	ADV	que
tout	PRO:IND	tout
ce	PRO:DEM	ce
qu'	PRO:REL	que
ils	PRO:PER	il
doivent	VER:pres	devoir
prendre	VER:infi	prendre
pour	PRP	pour
vivre	VER:infi	vivre
mérite	NOM	mérite
reconnaissance	NOM	reconnaissance
.	SENT	.
Ils	PRO:PER	il
pensent	VER:pres	penser
qu'	KON	que
ils	PRO:PER	il
font	VER:pres	faire
partie	VER:pper	partir
d'	PRP	de
un	DET:ART	un
Tout	NOM	tout
dans	PRP	dans
lequel	PRO:REL	lequel
il	PRO:PER	il
faudra	VER:futu	falloir
rendre	VER:infi	rendre
un	DET:ART	un
jour	NOM	jour
ce	PRO:DEM	ce
qu'	PRO:REL	que
ils	PRO:PER	il
ont	VER:pres	avoir
pris	VER:pper	prendre
.	SENT	.
J'	PRO:PER	je
ai	VER:pres	avoir
pensé	VER:pper	penser
à	PRP	à
la	DET:ART	le
spiritualité	NOM	spiritualité
des	PRP:det	du
indiens	NOM	indien
américains	ADJ	américain
mais	KON	mais
aussi	ADV	aussi
à	PRP	à
la	DET:ART	le
spiritualité	NOM	spiritualité
asiatique	ADJ	asiatique
quand	KON	quand
ils	PRO:PER	il
parlaient	VER:impf	parler
des	PRP:det	du
courants	NOM	courant
d'	PRP	de
énergie	NOM	énergie
qui	PRO:REL	qui
nous	PRO:PER	nous
entourent	VER:pres	entourer
.	SENT	.
