Film	NOM	film
impressionant	ADJ	impressionant
visuellement	ADV	visuellement
mais	KON	mais
seulement	ADV	seulement
les	DET:ART	le
personnages	NOM	personnage
totalement	ADV	totalement
creux	ADJ	creux
,	PUN	,
le	DET:ART	le
scénar	NOM	scénar
prévisible	ADJ	prévisible
et	KON	et
niais	ADJ	niais
,	PUN	,
la	DET:ART	le
mise	NOM	mise
en	PRP	en
scène	NOM	scène
moins	ADV	moins
pensée	VER:pper	penser
que	KON	que
dans	PRP	dans
Terminator	NAM	Terminator
ou	KON	ou
True	NAM	True
Lies	NAM	Lies
confirment	VER:pres	confirmer
ce	PRO:DEM	ce
que	PRO:REL	que
je	PRO:PER	je
craignais	VER:impf	craindre
,	PUN	,
Cameron	NAM	Cameron
a	VER:pres	avoir
craqué	VER:pper	craquer
avec	PRP	avec
le	DET:ART	le
succès	NOM	succès
de	PRP	de
Titanic	NAM	Titanic
,	PUN	,
où	PRO:REL	où
il	PRO:PER	il
avait	VER:impf	avoir
fait	VER:pper	faire
une	DET:ART	un
histoire	NOM	histoire
belle	ADJ	beau
et	KON	et
simple	ADJ	simple
même	ADJ	même
si	KON	si
simpliste	ADJ	simpliste
par	PRP	par
moment	NOM	moment
,	PUN	,
Avatar	NAM	Avatar
est	VER:pres	être
une	DET:ART	un
histoire	NOM	histoire
simpliste	ADJ	simpliste
qui	PRO:REL	qui
mise	VER:pres	miser
tout	ADV	tout
sur	PRP	sur
les	DET:ART	le
effets	NOM	effet
spéciaux	ADJ	spécial
.	SENT	.
Qui	PRO	qui
sont	VER:pres	être
très	ADV	très
bien	ADV	bien
,	PUN	,
mais	KON	mais
est	VER:pres	être
-ce	PRO:DEM	ce
que	KON	que
ça	PRO:DEM	cela
suffit	VER:pres	suffire
de	PRP	de
ne	ADV	ne
pas	ADV	pas
s'	PRO:PER	se
ennuyer	VER:infi	ennuyer
devant	PRP	devant
un	DET:ART	un
film	NOM	film
pour	PRP	pour
dire	VER:infi	dire
qu'	KON	que
il	PRO:PER	il
est	VER:pres	être
bon	ADJ	bon
?	SENT	?
