Après	PRP	après
12	NUM	@card@
ans	NOM	an
d'	PRP	de
absence	NOM	absence
,	PUN	,
James	NAM	James
Cameron	NAM	Cameron
revient	VER:pres	revenir
avec	PRP	avec
Avatar	NAM	Avatar
et	KON	et
confirme	VER:pres	confirmer
avec	PRP	avec
brio	NOM	brio
qu'	PRO:REL	que
il	PRO:PER	il
est	VER:pres	être
toujours	ADV	toujours
le	DET:ART	le
King	NAM	King
of	VER:futu	of
the	VER:pper	the
World	NAM	World
.	SENT	.
En	PRP	en
effet	NOM	effet
Avatar	NAM	Avatar
est	VER:pres	être
une	DET:ART	un
pure	ADJ	pur
merveille	NOM	merveille
esthétique	ADJ	esthétique
et	KON	et
les	DET:ART	le
nouvelles	ADJ	nouveau
technologies	NOM	technologie
n'	ADV	ne
auront	VER:futu	avoir
jamais	ADV	jamais
été	VER:pper	être
aussi	ADV	aussi
bien	ADV	bien
maitrisé	VER:pper	maitriser
.	SENT	.
Grace	NAM	Grace
a	VER:pres	avoir
ce	PRO:DEM	ce
projet	NOM	projet
ambitieux	ADJ	ambitieux
Cameron	NAM	Cameron
met	VER:pres	mettre
en	PRP	en
place	NOM	place
une	DET:ART	un
mythologie	NOM	mythologie
qui	PRO:REL	qui
pourrait	VER:cond	pouvoir
être	VER:infi	être
éxploité	VER:pper	éxploité
à	PRP	à
l'	DET:ART	le
infini	NOM	infini
cimme	ADJ	cimme
il	PRO:PER	il
l'	PRO:PER	la|le
avait	VER:impf	avoir
fait	VER:pper	faire
avec	PRP	avec
Terminator	NAM	Terminator
Esperons	VER:futu	Esperons
maintenant	ADV	maintenant
que	KON	que
Mr	ABR	monsieur
Cameron	NAM	Cameron
réalisera	VER:futu	réaliser
le	DET:ART	le
plus	ADV	plus
de	PRP	de
film	NOM	film
avant	PRP	avant
sa	DET:POS	son
mort	NOM	mort
,	PUN	,
ce	PRO:DEM	ce
qui	PRO:REL	qui
laissera	VER:futu	laisser
une	DET:ART	un
grande	ADJ	grand
empreinte	NOM	empreinte
dans	PRP	dans
le	DET:ART	le
cinéma	NOM	cinéma
