J’avoue	NOM	J’avoue
que	PRO:REL	que
j’étais	VER:impf	j’étais
réticent	ADJ	réticent
à	PRP	à
l’idée	ADJ	l’idée
de	PRP	de
voir	VER:infi	voir
cet	PRO:DEM	ce
Avatar	NOM	avatar
dont	PRO:REL	dont
tout	PRO:IND	tout
le	DET:ART	le
monde	NOM	monde
parlait	VER:impf	parler
depuis	PRP	depuis
un	DET:ART	un
moment	NOM	moment
.	SENT	.
Eh	INT	eh
bien	ADV	bien
encore	ADV	encore
une	DET:ART	un
fois	NOM	foi|fois
j’avais	VER:impf	j’avais
tort	NOM	tort
lol	NOM	lol
.	SENT	.
Ce	PRO:DEM	ce
film	NOM	film
est	VER:pres	être
une	DET:ART	un
merveille	NOM	merveille
d’imagination	NOM	d’imagination
,	PUN	,
de	PRP	de
technique	NOM	technique
et	KON	et
de	PRP	de
valeur	NOM	valeur
morale	ADJ	moral
.	SENT	.
En	PRP	en
effet	NOM	effet
,	PUN	,
la	DET:ART	le
destruction	NOM	destruction
de	PRP	de
la	DET:ART	le
nature	NOM	nature
par	PRP	par
l’homme	NOM	l’homme
sur	PRP	sur
la	DET:ART	le
planète	NOM	planète
des	PRP:det	du
Navis	NAM	Navis
représente	VER:pres	représenter
tout	ADV	tout
simplement	ADV	simplement
ce	PRO:DEM	ce
que	PRO:REL	que
nous	PRO:PER	nous
sommes	VER:pres	sommer|être
en	PRP	en
train	NOM	train
de	PRP	de
faire	VER:infi	faire
subir	VER:infi	subir
à	PRP	à
la	DET:ART	le
Terre	NAM	Terre
.	SENT	.
Peut-être	ADV	peut-être
que	KON	que
nos	DET:POS	notre
chers	ADJ	cher
dirigeants	NOM	dirigeant
auraient	VER:cond	avoir
dû	VER:pper	devoir
le	PRO:PER	le
visionner	VER:infi	visionner
avant	PRP	avant
leur	DET:POS	leur
sommet	NOM	sommet
de	PRP	de
Copenhaghe	NAM	Copenhaghe
afin	KON	afin
d’en	VER:simp	d’en
saisir	VER:infi	saisir
l’importance	NOM	l’importance
.	SENT	.
Question	NOM	question
effets	NOM	effet
spéciaux	ADJ	spécial
c’est	NOM	c’est
parfait	ADJ	parfait
,	PUN	,
tant	ADV	tant
le	DET:ART	le
bestiaire	NOM	bestiaire
inventé	VER:pper	inventer
par	PRP	par
Cameron	NAM	Cameron
que	KON	que
les	DET:ART	le
divers	ADJ	divers
vaisseaux	NOM	vaisseau
humains	ADJ	humain
.	SENT	.
On	PRO:PER	on
ressent	VER:pres	ressentir
même	ADV	même
autant	ADV	autant
d'	PRP	de
émotion	NOM	émotion
avec	PRP	avec
les	DET:ART	le
personnages	NOM	personnage
virtuels	ADJ	virtuel
qu'	KON	que
avec	PRP	avec
de	PRP	de
vrais	ADJ	vrai
acteurs	NOM	acteur
.	SENT	.
Enfin	ADV	enfin
la	DET:ART	le
3D	NOM	3D
permet	VER:pres	permettre
de	PRP	de
s’immerger	NOM	s’immerger
de	PRP	de
façon	NOM	façon
un	DET:ART	un
peu	ADV	peu
plus	ADV	plus
prononcé	VER:pper	prononcer
dans	PRP	dans
cet	PRO:DEM	ce
univers	NOM	univers
fantastique	ADJ	fantastique
.	SENT	.
Plus	ADV	plus
qu’un	ADJ	qu’un
film	NOM	film
,	PUN	,
une	DET:ART	un
aventure	NOM	aventure
.	SENT	.
