Film	NOM	film
non	ADV	non
prévue	VER:pper	prévoir
dans	PRP	dans
mon	DET:POS	mon
agenda	NOM	agenda
ciné	NOM	ciné
mais	KON	mais
devant	PRP	devant
le	DET:ART	le
phénomène	NOM	phénomène
avatar	NOM	avatar
je	PRO:PER	je
voulais	VER:impf	vouloir
me	PRO:PER	me
faire	VER:infi	faire
mon	DET:POS	mon
propre	ADJ	propre
avis	NOM	avis
.	SENT	.
Avis	NOM	avis
mitigé	VER:pper	mitiger
car	KON	car
certes	ADV	certes
on	PRO:PER	on
ne	ADV	ne
peut	VER:pres	pouvoir
pas	ADV	pas
être	VER:infi	être
insensible	ADJ	insensible
a	VER:pres	avoir
l'	DET:ART	le
extrême	ADJ	extrême
beauté	NOM	beauté
des	PRP:det	du
graphismes	NOM	graphisme
du	PRP:det	du
film	NOM	film
qui	PRO:REL	qui
se	PRO:PER	se
démarque	VER:pres	démarquer
de	PRP	de
toute	PRO:IND	tout
autre	ADJ	autre
film	NOM	film
ce	PRO:DEM	ce
qui	PRO:REL	qui
est	VER:pres	être
déjà	ADV	déjà
une	DET:ART	un
grande	ADJ	grand
qualité	NOM	qualité
mais	KON	mais
l'	DET:ART	le
ensemble	NOM	ensemble
révélé	VER:pper	révéler
des	PRP:det	du
petits	ADJ	petit
defaults	NOM	defaults
.	SENT	.
Pas	ADV	pas
mal	ADV	mal
d'	PRP	de
images	NOM	image
invite	NOM	invite
a	VER:pres	avoir
un	DET:ART	un
voyage	NOM	voyage
agréable	ADJ	agréable
d'ailleurs	ADV	d'ailleurs
les	DET:ART	le
deux	NUM	deux
premières	NUM	premier
heures	NOM	heure
du	PRP:det	du
films	NOM	film
sont	VER:pres	être
bonne	ADJ	bon
mais	KON	mais
y	PRO:PER	y
avait	VER:impf	avoir
t'	PRO:PER	te
il	PRO:PER	il
un	DET:ART	un
intérêt	NOM	intérêt
de	PRP	de
faire	VER:infi	faire
45min	NOM	45min
de	PRP	de
bataille	NOM	bataille
brouillonne	ADJ	brouillon
parfois	ADV	parfois
et	KON	et
surtout	ADV	surtout
répétitive	ADJ	répétitif
.	SENT	.
Le	DET:ART	le
scénario	NOM	scénario
est	VER:pres	être
lui	PRO:PER	lui
très	ADV	très
moyen	ADJ	moyen
même	ADV	même
les	DET:ART	le
fans	NOM	fan
l'	PRO:PER	la|le
avoue	VER:pres	avouer
mais	KON	mais
en	PRP	en
même	ADJ	même
temp	NOM	temp
c'	PRO:DEM	ce
est	VER:pres	être
pas	ADV	pas
ce	PRO:DEM	ce
que	PRO:REL	que
je	PRO:PER	je
cherche	VER:pres	chercher
a	VER:pres	avoir
mettre	VER:infi	mettre
en	PRP	en
avant	PRP	avant
le	DET:ART	le
réalisateur	NOM	réalisateur
dans	PRP	dans
ce	PRO:DEM	ce
film	NOM	film
,	PUN	,
on	PRO:PER	on
l'	PRO:PER	la|le
a	VER:pres	avoir
bien	ADV	bien
compris	VER:pper	comprendre
avatar	NOM	avatar
est	VER:pres	être
un	DET:ART	un
choc	NOM	choc
visuel	ADJ	visuel
voila	VER:simp	voiler
tout	ADV	tout
.	SENT	.
