Un	DET:ART	un
4/4	NUM	@card@
n'	ADV	ne
ont	VER:pres	avoir
pas	ADV	pas
pour	PRP	pour
remonter	VER:infi	remonter
les	DET:ART	le
imbéciles	NOM	imbécile
qui	PRO:REL	qui
mettent	VER:pres	mettre
0/4,1/4	NUM	@card@
avec	PRP	avec
des	PRP:det	du
arguments	NOM	argument
sortant	VER:ppre	sortir
de	PRP	de
leurs	DET:POS	leur
bétises	NOM	bétises
innées	ADJ	inné
,	PUN	,
mais	KON	mais
pour	PRP	pour
un	DET:ART	un
film	NOM	film
incroyablement	ADV	incroyablement
magique	ADJ	magique
,	PUN	,
avec	PRP	avec
une	DET:ART	un
faune	NOM	faune
et	KON	et
flore	NOM	flore
créative	ADJ	créatif
et	KON	et
magnifique	ADJ	magnifique
,	PUN	,
des	PRP:det	du
personnages	NOM	personnage
bien	ADV	bien
choisi	VER:pper	choisir
dans	PRP	dans
leurs	DET:POS	leur
rôles	NOM	rôle
,	PUN	,
surtout	ADV	surtout
Zoe	NAM	Zoe
Saldana	NAM	Saldana
alias	ADV	alias
Neytiri	NAM	Neytiri
qui	PRO:REL	qui
joue	VER:pres	jouer
d'	PRP	de
une	DET:ART	un
façon	NOM	façon
grandiose	ADJ	grandiose
,	PUN	,
c'	PRO:DEM	ce
est	VER:pres	être
déconcertant	ADJ	déconcertant
d'ailleurs	ADV	d'ailleurs
...	PUN	...
ajouter	VER:infi	ajouter
cela	PRO:DEM	cela
un	DET:ART	un
scénario	NOM	scénario
qui	PRO:REL	qui
tient	VER:pres	tenir
la	DET:ART	le
route	NOM	route
et	KON	et
bien	ADV	bien
sur	PRP	sur
bande	NOM	bande
son	DET:POS	son
surperbe	NOM	surperbe
.	SENT	.
Un	DET:ART	un
4/4	NUM	@card@
amplement	ADV	amplement
mérité	VER:pper	mériter
pour	PRP	pour
ce	PRO:DEM	ce
film	NOM	film
que	KON	que
james	NOM	james
cameron	NOM	cameron
nous	PRO:PER	nous
as	VER:pres	avoir
inventé	VER:pper	inventer
!	SENT	!
Un	DET:ART	un
grand	ADJ	grand
merci	NOM	merci
à	PRP	à
lui	PRO:PER	lui
et	KON	et
vivement	ADV	vivement
la	DET:ART	le
suite	NOM	suite
!	SENT	!
.	SENT	.
