après	PRP	après
deux	NUM	deux
bonnes	ADJ	bon
adaptations	NOM	adaptation
de	PRP	de
a	VER:pres	avoir
BD	ABR	BD
célèbre	ADJ	célèbre
,	PUN	,
astérix	NOM	astérix
et	KON	et
obélix	NOM	obélix
chutent	VER:pres	chuter
le	DET:ART	le
ciel	NOM	ciel
tombe	VER:pres	tomber
sur	PRP	sur
leurs	DET:POS	leur
tête	NOM	tête
il	PRO:PER	il
dénature	VER:pres	dénaturer
la	DET:ART	le
Bd	NAM	Bd
,	PUN	,
le	DET:ART	le
plus	ADV	plus
important	ADJ	important
,	PUN	,
les	DET:ART	le
seules	ADJ	seul
bonnes	ADJ	bon
scènes	NOM	scène
sont	VER:pres	être
celles	PRO:DEM	celui
avec	PRP	avec
césar	NOM	césar
qui	PRO:REL	qui
est	VER:pres	être
le	DET:ART	le
meilleur	ADJ	meilleur
césar	NOM	césar
des	PRP:det	du
trois	NUM	trois
films	NOM	film
très	ADV	très
présent	ADJ	présent
,	PUN	,
et	KON	et
surtout	ADV	surtout
pourquoi	ADV	pourquoi
?	SENT	?
pourquoi	ADV	pourquoi
le	DET:ART	le
film	NOM	film
s'	PRO:PER	se
apelle	VER:pres	apelle
Astérix	NAM	Astérix
aux	PRP:det	au
Jeux	NAM	Jeux
Olympiques	NAM	Olympiques
?	SENT	?
Le	DET:ART	le
film	NOM	film
devrait	VER:cond	devoir
s'	PRO:PER	se
apeller	VER:infi	apeller
Brutus	NAM	Brutus
aux	PRP:det	au
jeux	NOM	jeu
olympiques	ADJ	olympique
.	SENT	.
A	PRP	à
force	NOM	force
de	PRP	de
vouloir	VER:infi	vouloir
mettre	VER:infi	mettre
beaucoup	ADV	beaucoup
de	PRP	de
stars	NOM	star
célèbres	ADJ	célèbre
les	DET:ART	le
personnages	NOM	personnage
principaux	ADJ	principal
astérix	NOM	astérix
et	KON	et
obélix	NOM	obélix
sont	VER:pres	être
complètement	ADV	complètement
effacés	VER:pper	effacer
dommage	NOM	dommage
car	KON	car
clovis	NOM	clovis
cornillac	ADJ	cornillac
est	VER:pres	être
vraiment	ADV	vraiment
très	ADV	très
bien	ADV	bien
dans	PRP	dans
son	DET:POS	son
rôle	NOM	rôle
.	SENT	.
