quelle	PRO:REL	quel
deception	NOM	deception
!	SENT	!
Autant	ADV	autant
de	PRP	de
fric	NOM	fric
pour	PRP	pour
un	DET:ART	un
resultat	NOM	resultat
pareil	ADJ	pareil
?	SENT	?
...	PUN	...
A	PRP	à
NE	NAM	NE
VOIR	NAM	VOIR
QUE	NAM	QUE
POUR	NAM	POUR
ACCOMPAGNER	NAM	ACCOMPAGNER
DES	NAM	DES
ENFANTS	NAM	ENFANTS
QUI	NAM	QUI
EUX	NAM	EUX
S'	NAM	S'
AMUSERONT	NAM	AMUSERONT
...	PUN	...
seul	ADJ	seul
jules-Delon-cesar	NOM	jules-Delon-cesar
,	PUN	,
impérial	ADJ	impérial
sauve	VER:pres	sauver
le	DET:ART	le
film	NOM	film
d'	PRP	de
un	DET:ART	un
zero	NOM	zero
pointé	ADJ	pointé
...	PUN	...
Polvoorde	NAM	Polvoorde
est	VER:pres	être
bon	ADJ	bon
mais	KON	mais
un	DET:ART	un
peu	ADV	peu
lourd	ADJ	lourd
quand	KON	quand
meme.	ADJ	meme.
.	SENT	.
OU	KON	ou
SONT	NAM	SONT
Asterix	NAM	Asterix
et	KON	et
Obelix	NAM	Obelix
?	SENT	?
ils	PRO:PER	il
ont	VER:pres	avoir
des	PRP:det	du
quasi	ADV	quasi
seconds	NUM	second
roles.	ABR	roles.
.	SENT	.
Dubosc	NAM	Dubosc
est	VER:pres	être
à	PRP	à
peine	NOM	peine
visible	ADJ	visible
...	PUN	...
D'	ADJ	D'
accords	NOM	accord
les	DET:ART	le
effets	NOM	effet
spéciaux	ADJ	spécial
mettent	VER:pres	mettre
un	DET:ART	un
peu	ADV	peu
de	PRP	de
folie	NOM	folie
au	PRP:det	au
film	NOM	film
,	PUN	,
mais	KON	mais
le	DET:ART	le
scénario	NOM	scénario
est	VER:pres	être
ultra	ADJ	ultra
light	NOM	light
...	PUN	...
Un	ABR	Un
casting	NOM	casting
aussi	ADV	aussi
complet	ADJ	complet
ne	ADV	ne
suffit	VER:pres	suffire
pas	ADV	pas
à	PRP	à
sauver	VER:infi	sauver
le	DET:ART	le
vide	NOM	vide
existant	VER:ppre	exister
mais	KON	mais
garantira	VER:futu	garantir
aux	PRP:det	au
producteurs	NOM	producteur
ce	PRO:DEM	ce
qui	PRO:REL	qui
est	VER:pres	être
le	DET:ART	le
^plus	NOM	^plus
important	ADJ	important
pour	PRP	pour
lui	PRO:PER	lui
,	PUN	,
le	DET:ART	le
box	NOM	box
office	NOM	office
...	PUN	...
.	SENT	.
ON	PRO:PER	on
EST	VER:cond	EST
TRES	NAM	TRES
LOIN	NAM	LOIN
DE	NAM	DE
LA	NAM	LA
VERSION	NAM	VERSION
"	PUN:cit	"
fraiche	NOM	fraiche
"	PUN:cit	"
D'	ADJ	D'
alain	NOM	alain
CHABAT	NAM	CHABAT
...	PUN	...
