Semblables	ADJ	semblable
à	PRP	à
beaucoup	ADV	beaucoup
de	PRP	de
comédies	NOM	comédie
supermarketé	ADJ	supermarketé
,	PUN	,
l'	DET:ART	le
ensemble	NOM	ensemble
des	PRP:det	du
passages	NOM	passage
qui	PRO:REL	qui
font	VER:pres	faire
sourrire	NOM	sourrire
ont	VER:pres	avoir
été	VER:pper	être
vus	VER:pper	voir
dans	PRP	dans
les	DET:ART	le
nombreuses	ADJ	nombreux
bandes	NOM	bande
annonces	NOM	annonce
.	SENT	.
Les	DET:ART	le
nombreux	ADJ	nombreux
acteurs	NOM	acteur
ayant	VER:ppre	avoir
participés	VER:pper	participer
au	PRP:det	au
projet	NOM	projet
nous	PRO:PER	nous
offrent	VER:pres	offrir
à	PRP	à
tour	NOM	tour
de	PRP	de
rôle	NOM	rôle
des	PRP:det	du
moments	NOM	moment
amusants	ADJ	amusant
qui	PRO:REL	qui
nous	PRO:PER	nous
évite	VER:pres	éviter
de	PRP	de
quitter	VER:infi	quitter
la	DET:ART	le
salle	NOM	salle
avant	PRP	avant
la	DET:ART	le
fin	NOM	fin
.	SENT	.
Le	DET:ART	le
scenario	NOM	scenario
est	VER:pres	être
très	ADV	très
léger	ADJ	léger
et	KON	et
le	DET:ART	le
dernier	ADJ	dernier
quart	NOM	quart
d'	PRP	de
heure	NOM	heure
du	PRP:det	du
film	NOM	film
beaucoup	ADV	beaucoup
trop	ADV	trop
long	ADJ	long
.	SENT	.
L'	DET:ART	le
humour	NOM	humour
est	VER:pres	être
aproximatif	ADJ	aproximatif
et	KON	et
les	DET:ART	le
nombreux	ADJ	nombreux
sportifs	NOM	sportif
qui	PRO:REL	qui
se	PRO:PER	se
succèdent	VER:pres	succéder
à	PRP	à
l'	DET:ART	le
écran	NOM	écran
auraient	VER:cond	avoir
du	PRP:det	du
rester	VER:infi	rester
sur	PRP	sur
leur	DET:POS	leur
terrain	NOM	terrain
car	KON	car
n'	ADV	ne
est	VER:pres	être
pas	ADV	pas
acteur	NOM	acteur
qui	PRO:REL	qui
veut	VER:pres	vouloir
.	SENT	.
A	PRP	à
réserver	VER:infi	réserver
à	PRP	à
un	DET:ART	un
public	NOM	public
très	ADV	très
jeune	ADJ	jeune
.	SENT	.
