Ce	PRO:DEM	ce
3éme	ADJ	3éme
opus	NOM	opus
d’Astérix	NOM	d’Astérix
me	PRO:PER	me
semble	VER:pres	sembler
être	VER:infi	être
finalement	ADV	finalement
le	DET:ART	le
moins	ADV	moins
raté	VER:pper	rater
.	SENT	.
Après	PRP	après
Chabat	NAM	Chabat
dont	PRO:REL	dont
l’univers	NOM	l’univers
ne	ADV	ne
coïncidait	VER:impf	coïncider
pas	ADV	pas
avec	PRP	avec
celui	PRO:DEM	celui
de	PRP	de
Goscinny-Uderzo	NAM	Goscinny-Uderzo
et	KON	et
ressemblait	VER:impf	ressembler
à	PRP	à
une	DET:ART	un
mauvaise	ADJ	mauvais
compilation	NOM	compilation
des	PRP:det	du
blagues	NOM	blague
des	PRP:det	du
Nuls	NAM	Nuls
,	PUN	,
le	DET:ART	le
duo	NOM	duo
Langmann-Forestier	NAM	Langmann-Forestier
mise	VER:pper	mettre
sur	PRP	sur
son	DET:POS	son
casting	NOM	casting
et	KON	et
force	NOM	force
est	VER:pres	être
de	PRP	de
constater	VER:infi	constater
que	KON	que
Cornillac	NAM	Cornillac
est	VER:pres	être
parfait	ADJ	parfait
(	PUN	(
Clavier	NAM	Clavier
n’a	NOM	n’a
jamais	ADV	jamais
été	VER:pper	être
crédible	ADJ	crédible
)	PUN	)
et	KON	et
Poelvoorde	NAM	Poelvoorde
et	KON	et
Delon	NAM	Delon
,	PUN	,
avec	PRP	avec
des	PRP:det	du
rôles	NOM	rôle
plus	ADV	plus
longs	ADJ	long
,	PUN	,
sont	VER:pres	être
synchrones	ADJ	synchrone
avec	PRP	avec
l’univers	NOM	l’univers
du	PRP:det	du
petit	ADJ	petit
gaulois	ADJ	gaulois
.	SENT	.
Puisque	KON	puisque
la	DET:ART	le
série	NOM	série
Astérix	NAM	Astérix
repose	VER:pres	reposer
essentiellement	ADV	essentiellement
sur	PRP	sur
une	DET:ART	un
gestion	NOM	gestion
de	PRP	de
caractères	NOM	caractère
,	PUN	,
miser	VER:infi	miser
sur	PRP	sur
un	DET:ART	un
bon	ADJ	bon
casting	NOM	casting
avec	PRP	avec
des	PRP:det	du
personnages	NOM	personnage
moins	ADV	moins
anecdotiques	ADJ	anecdotique
est	VER:pres	être
le	DET:ART	le
bon	ADJ	bon
choix	NOM	choix
et	KON	et
le	DET:ART	le
film	NOM	film
réussit	VER:pres	réussir
à	PRP	à
être	VER:infi	être
ce	PRO:DEM	ce
qu’il	NOM	qu’il
prétend	VER:pres	prétendre
être	VER:infi	être
,	PUN	,
à	PRP	à
savoir	VER:infi	savoir
une	DET:ART	un
comédie	NOM	comédie
familiale	ADJ	familial
pas	ADV	pas
trop	ADV	trop
moche	ADJ	moche
.	SENT	.
Par	PRP	par
contre	NOM	contre
,	PUN	,
la	DET:ART	le
course	NOM	course
de	PRP	de
chars	NOM	char
finale	ADJ	final
,	PUN	,
sensée	ADJ	sensé
être	NOM	être
le	DET:ART	le
clou	NOM	clou
du	PRP:det	du
spectacle	NOM	spectacle
,	PUN	,
est	VER:pres	être
un	DET:ART	un
peu	ADV	peu
molle	ADJ	mou
et	KON	et
la	DET:ART	le
séquence	NOM	séquence
de	PRP	de
conclusion	NOM	conclusion
ressemble	VER:pres	ressembler
à	PRP	à
un	DET:ART	un
énorme	ADJ	énorme
clip	NOM	clip
publicitaire	ADJ	publicitaire
avec	PRP	avec
ces	PRO:DEM	ce
sportifs	NOM	sportif
inexpressifs	ADJ	inexpressif
sortis	VER:pper	sortir
de	PRP	de
nulle	ADJ	nul
part	NOM	part
.	SENT	.
