Nul	ADJ	nul
,	PUN	,
pathétique	ADJ	pathétique
,	PUN	,
mauvais	ADJ	mauvais
,	PUN	,
lourd	ADJ	lourd
,	PUN	,
insupportable	ADJ	insupportable
sont	VER:pres	être
les	DET:ART	le
quelques	PRO:IND	quelque
adjectifs	NOM	adjectif
qui	PRO:REL	qui
me	PRO:PER	me
reviennent	VER:pres	revenir
sans	PRP	sans
cesse	NOM	cesse
lorsque	KON	lorsque
je	PRO:PER	je
me	PRO:PER	me
remémore	VER:pres	remémorer
l'	DET:ART	le
atroce	ADJ	atroce
moment	NOM	moment
de	PRP	de
souffrance	NOM	souffrance
silencieuse	ADJ	silencieux
endurée	VER:pper	endurer
dans	PRP	dans
la	DET:ART	le
salle	NOM	salle
...	PUN	...
Nos	NOM	Nos
scientifiques	ADJ	scientifique
n'	ADV	ne
ont	VER:pres	avoir
pas	ADV	pas
encore	ADV	encore
decouvert	NOM	decouvert
un	DET:ART	un
procédé	NOM	procédé
pour	PRP	pour
créer	VER:infi	créer
le	DET:ART	le
vide	ADJ	vide
absolu	NOM	absolu
...	PUN	...
mais	KON	mais
Braoudé	VER:pper	Braoudé
lui	PRO:PER	lui
,	PUN	,
sans	PRP	sans
faire	VER:infi	faire
de	PRP	de
bruit	NOM	bruit
et	KON	et
contre	PRP	contre
toutes	PRO:IND	tout
attentes	NOM	attente
,	PUN	,
pourrait	VER:cond	pouvoir
devenir	VER:infi	devenir
le	DET:ART	le
1er	NUM	1er
réalisateur	NOM	réalisateur
de	PRP	de
cinema	VER:simp	cinema
Prix	NAM	Prix
Nobel	NAM	Nobel
de	PRP	de
Physique	NAM	Physique
en	PRP	en
nous	PRO:PER	nous
proposant	VER:ppre	proposer
cette	PRO:DEM	ce
affreux	ADJ	affreux
ballet	NOM	ballet
daubique	NOM	daubique
tellement	ADV	tellement
vide	ADJ	vide
de	PRP	de
sens	NOM	sen|sens
et	KON	et
d'	PRP	de
humour	NOM	humour
qu'	PRO:REL	que
il	PRO:PER	il
remplacera	VER:futu	remplacer
les	DET:ART	le
chocs	NOM	choc
electriques	ADJ	electriques
dans	PRP	dans
les	DET:ART	le
asiles	NOM	asile
comme	KON	comme
méthode	NOM	méthode
de	PRP	de
lobotomisation	NOM	lobotomisation
.	SENT	.
Par	PRP	par
pitié	NOM	pitié
evitez	VER:pres	evitez
ce	PRO:DEM	ce
film	NOM	film
.	SENT	.
Il	PRO:PER	il
en	PRO:PER	en
va	VER:pres	aller
de	PRP	de
votre	DET:POS	votre
santé	NOM	santé
mentale	ADJ	mental
.	SENT	.
