Que	KON	que
dire	VER:infi	dire
?	SENT	?
une	DET:ART	un
Réalisation	NOM	réalisation
proche	ADJ	proche
du	PRP:det	du
Néant	NAM	Néant
,	PUN	,
la	DET:ART	le
mise	NOM	mise
en	PRP	en
scène	NOM	scène
banale	ADJ	banal
,	PUN	,
des	PRP:det	du
acteurs	NOM	acteur
fades	ADJ	fade
,	PUN	,
des	PRP:det	du
gags	NOM	gag
nuls	ADJ	nul
et	KON	et
rechauffés	VER:pper	rechauffer
même	ADV	même
les	DET:ART	le
effets	NOM	effet
spéciaux	ADJ	spécial
Le	DET:ART	le
film	NOM	film
se	PRO:PER	se
ridiculise	VER:pres	ridiculiser
lui	PRO:PER	lui
même	ADV	même
Benoit	VER:pres	Benoit
Poelvoorde	NAM	Poelvoorde
est	VER:pres	être
étouffant	ADJ	étouffant
par	PRP	par
son	DET:POS	son
jeu	NOM	jeu
d'	PRP	de
acteur	NOM	acteur
vu	VER:pper	voir
et	KON	et
rerevu	VER:pper	rerevu
...	PUN	...
Clovis	NAM	Clovis
Cornillac	NAM	Cornillac
est	VER:pres	être
fade	ADJ	fade
et	KON	et
tous	PRO:IND	tout
les	DET:ART	le
acteurs	NOM	acteur
se	PRO:PER	se
font	VER:pres	faire
bouffer	VER:infi	bouffer
par	PRP	par
les	DET:ART	le
constantes	ADJ	constant
dérives	NOM	dérive
de	PRP	de
Poelvoorde	NAM	Poelvoorde
qui	PRO:REL	qui
étouffe	VER:pres	étouffer
littéralement	ADV	littéralement
le	DET:ART	le
film	NOM	film
Il	VER:futu	Il
n'	ADV	ne
y	PRO:PER	y
a	VER:pres	avoir
pas	ADV	pas
que	KON	que
Alain	NAM	Alain
Delon	NAM	Delon
qui	PRO:REL	qui
sauve	VER:pres	sauver
le	DET:ART	le
film	NOM	film
en	PRP	en
faisant	VER:ppre	faire
une	DET:ART	un
propre	ADJ	propre
parodie	NOM	parodie
de	PRP	de
soi-même	ADJ	soi-même
L'	DET:ART	le
apparition	NOM	apparition
de	PRP	de
Jamel	NAM	Jamel
est	VER:pres	être
sympathique	ADJ	sympathique
cependant	ADV	cependant
il	PRO:PER	il
ne	ADV	ne
suffit	VER:pres	suffire
pas	ADV	pas
d'	PRP	de
avoir	VER:infi	avoir
pleins	ADJ	plein
de	PRP	de
stars	NOM	star
dans	PRP	dans
un	DET:ART	un
film	NOM	film
pour	PRP	pour
faire	VER:infi	faire
un	DET:ART	un
bon	ADJ	bon
produit	NOM	produit
Les	DET:ART	le
78	NUM	@card@
millions	NOM	million
d'	PRP	de
euros	NOM	euro
sont	VER:pres	être
partis	VER:pper	partir
en	PRP	en
fumée	NOM	fumée
dans	PRP	dans
cette	PRO:DEM	ce
oeuvre	NOM	œuvre
pitoyable	ADJ	pitoyable
qui	PRO:REL	qui
est	VER:pres	être
Astérix	NAM	Astérix
aux	PRP:det	au
Jeux	NAM	Jeux
Olympiques	NAM	Olympiques
Alain	NAM	Alain
Chabat	NAM	Chabat
me	PRO:PER	me
manque	VER:pres	manquer
...	PUN	...
