mais	KON	mais
comment	ADV	comment
on	PRO:PER	on
t'	PRO:PER	te
il	PRO:PER	il
fait	VER:pres	faire
pour	PRP	pour
fait	NOM	fait
une	DET:ART	un
tel	NOM	tel
horreur	NOM	horreur
ce	PRO:DEM	ce
film	NOM	film
et	KON	et
horrible	ADJ	horrible
laid	ADJ	laid
pas	ADV	pas
du	PRP:det	du
tout	NOM	tout
interessant	ADJ	interessant
er	VER:futu	er
il	PRO:PER	il
a	VER:pres	avoir
une	DET:ART	un
homosexualite	NOM	homosexualite
latente	ADJ	latent
tres	VER:simp	tres
bizarre	ADJ	bizarre
entre	PRP	entre
batman	NOM	batman
et	KON	et
robin	NOM	robin
on	PRO:PER	on
dirais	VER:cond	dire
que	KON	que
batgirl	NOM	batgirl
a	VER:pres	avoir
juste	ADJ	juste
a	VER:pres	avoir
etait	VER:impf	etait
mis	VER:pper	mettre
la	DET:ART	le
juste	ADJ	juste
parce	KON	parce
que	KON	que
les	DET:ART	le
producteurs	NOM	producteur
on	PRO:PER	on
trouver	VER:infi	trouver
ca	VER:impf	ca
trop	ADV	trop
abuser	VER:infi	abuser
enfin	ADV	enfin
les	DET:ART	le
dialogues	NOM	dialogue
sont	VER:pres	être
hallucinant	ADJ	hallucinant
je	PRO:PER	je
ne	ADV	ne
pense	VER:pres	penser
pas	ADV	pas
que	KON	que
vus	VER:pper	voir
le	DET:ART	le
succes	NOM	succes
qu'	PRO:REL	que
on	PRO:PER	on
connue	VER:pper	connaître
les	DET:ART	le
differents	ADJ	differents
acteurs	NOM	acteur
,	PUN	,
realisateurs	NOM	realisateurs
etc	ABR	etc
etc	ABR	etc
...	PUN	...
pourquoi	ADV	pourquoi
on	PRO:PER	on
t'	PRO:PER	te
il	PRO:PER	il
tourner	VER:infi	tourner
dans	PRP	dans
ce	PRO:DEM	ce
film	NOM	film
problemes	NOM	problemes
d'	PRP	de
impots	ADJ	impots
menaces	NOM	menace
de	PRP	de
la	DET:ART	le
mafia	NOM	mafia
c'	PRO:DEM	ce
est	VER:pres	être
pas	ADV	pas
possible	ADJ	possible
a	VER:pres	avoir
voir	VER:infi	voir
a	VER:pres	avoir
la	DET:ART	le
limite	NOM	limite
super	ADJ	super
bourre	VER:pres	bourrer
avec	PRP	avec
des	PRP:det	du
potes	NOM	pote
pour	PRP	pour
rigoler	VER:infi	rigoler
mais	KON	mais
sinon	KON	sinon
