Quelle	PRO:REL	quel
catastrophe	VER:pres	catastropher
!	SENT	!
Après	PRP	après
le	DET:ART	le
deuxième	NUM	deuxième
opus	NOM	opus
réalisé	VER:pper	réaliser
par	PRP	par
Alain	NAM	Alain
Chabat	NAM	Chabat
,	PUN	,
nous	PRO:PER	nous
savions	VER:impf	savoir
que	KON	que
ce	PRO:DEM	ce
troisième	NUM	troisième
volet	NOM	volet
serait	VER:cond	être
moins	ADV	moins
intéressant	ADJ	intéressant
.	SENT	.
Mais	KON	mais
nous	PRO:PER	nous
ne	ADV	ne
pensions	VER:impf	penser
pas	ADV	pas
qu'	KON	que
il	PRO:PER	il
serait	VER:cond	être
aussi	ADV	aussi
mauvais	ADJ	mauvais
:	PUN	:
Scénario	NOM	scénario
inexistant	ADJ	inexistant
,	PUN	,
pléthore	NOM	pléthore
de	PRP	de
Guests	NAM	Guests
Stars	NAM	Stars
souvent	ADV	souvent
inutiles	ADJ	inutile
,	PUN	,
lenteurs	NOM	lenteur
,	PUN	,
histoire	NOM	histoire
qui	PRO:REL	qui
part	VER:pres	partir
dans	PRP	dans
tous	PRO:IND	tout
les	DET:ART	le
sens	NOM	sen|sens
,	PUN	,
aucune	PRO:IND	aucun
réelle	ADJ	réel
bataille	NOM	bataille
Gaulois/Romains	NAM	Gaulois/Romains
...	PUN	...
Et	NOM	Et
comme	ADV	comme
prévu	VER:pper	prévoir
,	PUN	,
les	DET:ART	le
duos	NOM	duo
formés	ADJ	formé
par	PRP	par
Alafolix/Irina	NAM	Alafolix/Irina
et	KON	et
César/Brutus	NAM	César/Brutus
tuent	VER:pres	tuer
le	DET:ART	le
film	NOM	film
car	KON	car
ce	PRO:DEM	ce
dernier	NOM	dernier
ne	ADV	ne
se	PRO:PER	se
concentre	VER:pres	concentrer
que	KON	que
sur	PRP	sur
cela	PRO:DEM	cela
,	PUN	,
oubliant	VER:ppre	oublier
jusqu'	PRP	jusque
au	PRP:det	au
simple	ADJ	simple
fait	NOM	fait
que	KON	que
ce	PRO:DEM	ce
film	NOM	film
traite	VER:subp	traiter
avant	PRP	avant
tout	PRO:IND	tout
d'	PRP	de
Astérix	NAM	Astérix
et	KON	et
Obélix	NAM	Obélix
!	SENT	!
Mais	KON	mais
le	DET:ART	le
problème	NOM	problème
majeur	ADJ	majeur
reste	VER:pres	rester
que	KON	que
90	NUM	@card@
%	SYM	%
des	PRP:det	du
gags	NOM	gag
du	PRP:det	du
film	NOM	film
ne	ADV	ne
sont	VER:pres	être
PAS	NAM	PAS
DRÔLES	NAM	DRÔLES
!	SENT	!
Enfin	ADV	enfin
,	PUN	,
et	KON	et
si	KON	si
les	DET:ART	le
acteurs	NOM	acteur
sont	VER:pres	être
à	PRP	à
peu	ADV	peu
près	ADV	près
honnorables	ADJ	honnorables
dans	PRP	dans
leurs	DET:POS	leur
rôles	NOM	rôle
respectifs	ADJ	respectif
,	PUN	,
ce	PRO:DEM	ce
sont	VER:pres	être
les	DET:ART	le
personnages	NOM	personnage
qu'	PRO:REL	que
ils	PRO:PER	il
incarnent	VER:pres	incarner
qui	PRO:REL	qui
ont	VER:pres	avoir
été	VER:pper	être
complètement	ADV	complètement
masacrés	VER:pper	masacrés
par	PRP	par
les	DET:ART	le
réalisateurs	NOM	réalisateur
et	KON	et
qui	PRO:REL	qui
donnent	VER:pres	donner
au	PRP:det	au
final	ADJ	final
un	DET:ART	un
goût	NOM	goût
pitoyable	ADJ	pitoyable
.	SENT	.
Ce	PRO:DEM	ce
film	NOM	film
est	VER:pres	être
une	DET:ART	un
honte	NOM	honte
.	SENT	.
Et	KON	et
vous	PRO:PER	vous
pensiez	VER:impf	penser
,	PUN	,
chers	ADJ	cher
lecteurs	NOM	lecteur
d'	PRP	de
Astérix	NAM	Astérix
,	PUN	,
que	KON	que
le	DET:ART	le
dernier	ADJ	dernier
album	NOM	album
d'	PRP	de
Uderzo	NAM	Uderzo
était	VER:impf	être
minable	ADJ	minable
?	SENT	?
Attendez	VER:pres	attendre
de	PRP	de
voir	VER:infi	voir
ce	PRO:DEM	ce
film	NOM	film
...	PUN	...
